18.ox
.....ooo...o...o..
o.oo...........o..
......o..o......o.
.....oo......o....
.o.........o.....o
.....o............
...o.........o...o
..o..o.....o....o.
.o..............o.
......o.....o.....
.........o.o......
.....o......o...o.
.....o...o..oo..oo
...oooo.o.........
...oo....o...oo...
o.........o....oo.
....oo..........o.
o.........o...oo..
