18.ox
o.....o.......o...
.o...ooo....o..ooo
.o.ooo............
o...o......o.oo..o
o...o.........ooo.
o.....o.o.........
......o...oo...o..
..o....o.o..o.o...
..ooo.o........o..
o...o...o....o..o.
.oo..o...........o
o..o....o..oo....o
......o...oooo...o
.oo..oo......o....
..oo...o.oo.ooo.o.
.............oo...
...o.o..o.....oo.o
ooo.....oo...o..o.
